###############
#S  #         #
### ### ### # #
# #   #   # # #
# ### ### # ###
# #       #   #
# # ######### #
#       # #   #
##### # # # ###
#   # #   #   #
# # # ### #####
# # #   # #   #
# # ### # # # #
# #     #   #G#
###############
