#####################
#   #       #   #   #
# # # # ##### # # ###
# # # #     # # # # #
# # # ##### # # # # #
# #   # #   # # # # #
# ##### # ### # # # #
# #     # #   # #   #
# ### ### # ### ### #
#   #   #   #   #   #
### ### ##### ### ###
# #         #     # #
# ######### ####### #
#   #     # # #     #
# # # # ### # # ### #
# #   #   # #   #   #
# ####### # # ### ###
# #     # # #   #   #
# # ### # # ####### #
#   #   #           #
#####################
