#####################
#     #         #   #
# ### ####### # ### #
# # #       # #   # #
# # ######### ### # #
#         # #   #   #
######### # # # #####
#   #     #   #     #
# ### ############# #
#     #             #
# ####### ######### #
# #       # #       #
# ##### ### # #######
#       # #   #     #
######### # ### ### #
#   #     #   # #   #
# # # # ##### # ### #
# #   # #     #   # #
# ##### # ####### # #
#     #           # #
#####################
