#####################
#         #     #   #
# # ####### ### # # #
# #     #   #   # # #
# ##### # ### ### # #
#     #   # #     # #
##### ##### ####### #
#   # #         # # #
# # # ####### # # ###
# # #     #   # #   #
# # ##### # ### # # #
# #   # #   #   # # #
# ### # ##### ### # #
#   #     # #   # # #
### ##### # ### # # #
#   #   # # #   # # #
# # # # # # # ### # #
# # # # #   #   # # #
# ### # ####### # # #
#     #           # #
#####################
